00000000000000
01000000111000
00000000000000
00011111000000
00001110000000
00000000000000
00000000000000
00100000000000
00100000000000
00100000110000
00000000100000
00010010000000
00111110000000
00000111000000
00000010000000
